     #####
     # & #
     #   #
     #   #
######   #
#        #
#x   @   #
#x   @   #
#        #
######   #
     #   #
	 #   #
	 #####